1111111111111111111111111111111111111111111111111111111111111111111111111111111111111111111111111111
1113333333111000001111111111111111111111111111111111111111111111111111111111111111111111111111111111
1333333333311000000000001111111111111111111111111111101111111111111111111111111111111111111111111111
1333333333331000000000000000000111111111111110000000000011111111111111111111111111111111111111111111
1333333333331000000000000000000000000011000000000000000000000000000000000000000111111111111111111111
1333333333331000000000000000000000000000000000000001100000000000000000000000000000111111111111111111
1333333333331000000000000000000000000000000001111111111111111000000000000000000000000111111111111111
133333333333000000000000000000000000000000000001111111111111111100000000000000000000011111111111111
113333333311000000000000000000000000000000000000000111111111111111110000000000000000001111111111111
1113333333111000000000000000000000000000000000000000000011111111111111110000000000000000111111111111
1113111111111000000000000000000000000000000000000000000000011111111111111100000000000000111111111111
1110000000000000000000000000000000000000000000000000000000000001111111111111000000000000011111111111
1110000000000000011100000000000000000000000000000000000000000000001111111111110000000000001111111111
1110000000000000111111111000000000000000000000000000000000000000000001111111111000000000001111111111
1110000000000001111111111111100000000000000000000000000000000000000000011111111100000000000111111111
1110000000000011111111111111111100000000000000000000000000000000000000001111111110000000000111111111
1110000000000011111111111111111111100000000000000000000000000000000000000111111111000000000011111111
1110000000000011111111111111111111111110000000000000000000000000000000000011111111100000000011111111
1110000000000011111111111111111111111000000000000000000000000000000000000001111111110000000011111111
1110000000000011111111111111111111110000000000000000000000000000000000000000111111111000000001111111
1110000000000001111111111111111111100000000000000000000000000000000000000000011111111100000001111111
1110000000000001111111111111111111000000000000000000000000000000000000000000011111111100000001111111
1110000000000001111111111111111110000000000000000000000000000000000000000000001111111110000001111111
1111000000000001111111111111111100000000000000000000000000000000000000000000000111111111000000111111
1111000000000000111111111111111100000000000000000100000000000000000000000000000111111111000000111111
1111000000000000111111111111111100000000000000011111000000000000000000000000000011111111100000111111
1111000000000000111111111111111000000000000001111111111000000000000000000000000001111111100000111111
1111000000000000111111111111111000000000000011111111111111000000000000000000000000111111110000011111
1111000000000000011111111111111000000000000011111111111111110000000000000000000000011111110000011111
1111000000000000011111111111110000000000000111111111111111111000000000000000000000001111111000011111
1111000000000000011111111111110000000000000111111111111111111110000000000000000000001111111000001111
1111000000000000001111111111110000000000001111111111111111111111000000000000000000000111111000001111
1111000000000000001111111111100000000000001111111111111111111111100000000000000000000011111000001111
1111000000000000001111111111100000000000001111111111111111111111110000000000000000000011111100001111
1111000000000000001111111111100000000000001111111111111111111111111000000000000000000001111100001111
1111000000000000000111111111100000000000011111111111111111111111111100000000000000000001111100001111
1111000000000000000111111111100000000000011111111111111111111111111110000000000000000000111100000111
1111000000000000000111111111100000000000011111111111111111111111111111000000000000000000111110000111
1111000000000000000011111111100000000000011111111111111111111111111111100000000000000000111110000111
1111000000000000000011111111110000000000011111111111111111111111111111110000000000000000011110000111
1111000000000000000011111111110000000000111111111111111111111111111111111000000000000000011110000111
1111000000000000000001111111110000000000111111111111111111111111111111111000000000000000001110000111
1111000000000000000001111111111000000000111111111111111111111111111111111100000000000000001111000111
1111000000000000000000111111111000000000011111111111111111111111111111111110000000000000000111000111
1111000000000000000000011111111100000000011111111111111111111111111111111110000000000000000111000111
1111000000000000000000011111111100000000011111111111111111111111111111111111000000000000000011000111
1111000000000000000000001111111110000000011111111111111111111111111111111111100000000000000011000111
1111000000000000000000001111111111000000001111111111111111111111111111111111100000000000000001000111
1111000000000000000000000111111111000000000111111110011111111111111111111111100000000000000001000111
1111000000000000000000000001111111100000000111111000011111111111111111111111110000000000000001000111
1111000000000000000000000000111111110000000011100000011111111111111111111111110000000000000000000111
1111000000000000000000000000011111111000000000000000111111111111111111111111111000000000000000001111
1111000000000000000000000000001111111100000000000001111111111111111111111111111000000000000000001111
1111000000000000000000000000001111111110000000000000000111111111111111111111111000000000000000001111
1111000000000000000000000000001111111111000000000000000000011111111111111111111100000000000000001111
1111000000000000000000000000000111111111111000000000000000000111111111111111111100000000000000001111
1111000000000000000000000000000011111111111111100000000000000001111111111111111100000000000000001111
1111000000000000000000000000000000111111111111111110000000000000011111111111111100000000000000001111
1110000000000001111110000000000000011111111111111111100000000000001111111111111110000000000000001111
1110000000001111111111111110000000001111111111111111111000000000000111111111111110000000000000001111
1110000000011111111111111111000000000111111111111111111100000000000011111111111111000000000000001111
1110000000111111111111111111110000000011111111111111111100000000000011111111111111000000000000001111
1110000000111111111111111111111000000011111111111111111110000000000001111111111111000000000000001111
1110000000111111111111111111111000000000111111111111111110000000000001111111111111100000000000001111
1110000000111111111111111111111100000000011111111111111111000000000001111111111111100000000000000111
1110000000111111111111111111111110000000001111111111111111000000000000111111111111100000000000000111
1110000000011111111111111111111110000000000000000001111111000000000000111111111111100000000000000111
1110000000011111111111111111111111000000000000000000000111000000000000111111111111110000000000000111
1110000000011111111111111111111111000000000000000000000000000000000000111111111111110000000000000111
1110000000001111111111111111111111000000000000000000000000000000000000011111111111110000000000000111
1110000000001111111111111111111111000000000000000000000000000000000000011111111111110000000000000111
1110000000001111111111111111111111000000000000000000000000000000000000011111111111111000000000000111
1110000000000111111111111111111111000000000000000000000000000000000000001111111111111000000000000111
1110000000000111111111111111111111000000001111110000000000000000000000000001111111111000000000000111
1110000000000011111111001111111111000000001111111000000000000000000000000000111111111100000000001111
1110000000000011111110000111111111000000001111111100000001100000000000000000001111111100000000001111
1110000000000001111100000111111111000000001111111110000011111000000000000000001111111100000000001111
1110000000000000111100000111111110000000001111111111000011111111000000000000001111111100000000001111
1110000000000000111100000111111110000000001111111111111111111111110000000000000111111100000000001111
1110000000000000011100000111111100000000001111111111111111111111111100000000000111111100000000011111
1110000000000000001100000111111000000000001111111111111111111111111111000000000011111100000000011111
1110000000000000000000000111110000000000001111111111111111111111111111000000000011111100000000011111
1110000000000000000000000111000000000000001111111111111111111111111111000000000011111100000000011111
1110000000000000000000000000000000000000011111111111111111111111111111000000000001111100000000011111
1111000000000000000000000000000000000000011111111111111111111111111111000000000001111100000000011111
1111000000000000000000000000000000000000011111111111111111111111111111000000000001111000000000011111
1111000000000000000000000000000000000000011111111111111111111111111111000000000000110000000000111111
1111100000000000000000000000000000000000111111111111111111111111111111000000000000100000000000111111
1111100000000000000000000000000000000001111111111111111111111111111111000000000000100000000000111111
1111110000000000000000000000000000000001111111111111111111111111111111000000000000000001111121111111
1111111000000000000000000000000000000011111111111111111111111111111111000000000000000001112222222111
1111111100000000000000000000000000000111111111111111111111111111111111000000000000000001122222222211
1111111110000000000000000000000000011111111111111111111111111111111111100000000000000001222222222221
1111111111000000000000000000000000111111111111111111111111111111111111100000000000000001222222222221
1111111111110000000000000000000001111111111111111111111111111111111111100000000000000001222222222221
1111111111111111011111111000000111111111111111111111111111111111111111110000000000000001222222222221
1111111111111111111111111111111111111111111111111111111111111111111111110000000000000002222222222221
1111111111111111111111111111111111111111111111111111111111111111111111111000000000000001122222222211
1111111111111111111111111111111111111111111111111111111111111111111111111111111110000001112222222111
1111111111111111111111111111111111111111111111111111111111111111111111111111111111111111111111111111
